12
46
21 21 21 21 21 21 21 21 21 21 21 21 21 21 21 21 21 21 21 21 21 21 21 21 21 21 21 21 21 21 21 21 21 21 21 21 21 21 21 21 21 21 21 21 21 21 
21 19 17 17 17 17 17 17 17 17 17 17 17 17 17 17 17 17 17 17 17 17 17 17 17 17 17 17 17 17 17 17 17 17 17 17 17 17 17 17 17 17 17 17 18 21 
21 4 0 0 0 0 0 0 0 0 0 0 0 0 0 0 0 0 0 0 0 0 0 0 0 0 0 0 0 0 0 0 0 0 0 0 0 0 0 0 0 0 0 0 3 21 
21 4 0 0 0 0 0 0 0 0 0 0 0 0 0 0 0 0 0 0 0 0 0 0 0 0 0 0 0 0 0 0 0 0 0 0 0 0 0 0 0 0 0 0 3 21 
21 4 0 0 0 0 0 0 0 0 0 0 0 0 0 0 0 0 0 0 0 0 0 0 0 0 0 0 0 0 0 0 0 0 0 0 0 0 0 0 0 0 0 0 16 21 
21 4 0 0 0 0 0 0 0 0 0 0 0 0 0 0 0 0 0 0 0 0 0 0 0 0 0 0 0 0 0 0 0 0 0 0 0 0 0 0 0 0 0 1 20 6 
21 4 0 0 0 0 0 0 0 0 0 0 0 0 0 0 0 0 0 0 0 0 0 0 0 0 0 0 22 23 24 0 0 0 0 0 0 22 23 23 23 24 0 3 21 21 
21 4 0 0 0 0 0 0 0 0 0 0 0 0 0 0 0 10 0 0 11 0 1 20 20 20 2 0 0 0 0 0 0 0 0 0 0 0 0 0 0 0 0 3 21 21 
21 4 0 0 0 0 0 0 0 0 10 0 0 9 0 0 22 23 23 23 24 0 3 21 21 21 4 0 0 0 0 25 0 0 0 0 0 0 0 0 0 0 0 3 21 21 
21 4 0 0 0 0 0 0 1 20 20 20 20 20 20 2 0 0 0 0 0 0 3 21 21 5 20 2 11 0 9 0 11 0 0 11 10 0 0 9 0 0 9 3 21 21 
21 4 0 0 0 0 0 1 20 6 21 21 21 21 21 4 0 0 0 0 0 0 3 21 21 21 5 20 20 20 20 20 20 20 20 20 20 20 20 20 20 20 20 20 6 21 
5 20 20 20 20 20 20 20 6 21 21 21 21 21 21 4 0 0 0 0 0 0 3 21 21 21 21 21 21 21 21 21 21 21 21 21 21 21 21 21 21 21 21 21 21 21 
