12
18
21 21 21 21 21 21 21 21 21 21 21 21 21 21 21 21 21 21 
21 19 17 17 17 17 17 17 17 17 17 17 17 17 17 17 18 21 
21 4 0 0 0 0 0 0 0 0 0 0 0 0 0 0 3 21 
21 4 0 0 0 0 0 0 0 0 0 0 0 0 0 0 3 21 
21 4 0 0 0 0 0 0 0 0 0 0 0 0 0 0 3 21 
21 4 0 0 0 0 0 0 0 0 0 0 0 0 0 0 3 21 
21 4 0 0 0 0 0 0 0 0 0 0 0 0 0 0 3 21 
21 4 0 0 0 0 0 0 0 0 0 0 0 0 0 0 3 21 
21 4 0 0 0 0 0 26 0 0 0 0 0 0 0 0 3 21 
21 4 0 0 0 0 22 23 23 24 0 0 0 0 0 0 3 21 
21 4 25 1 20 2 0 0 0 0 0 0 0 0 15 0 3 21 
5 20 20 20 7 20 20 20 20 20 20 20 20 20 20 20 20 6 
